[
  [0,0,0,0,0,0,0,0,0,0,0,0,0,0,0,0,0,0,0,0,0,0,0,0,0,0,0,0,0,0,0,0,0,0,0,0,0,0,0,0,0,0,0,0,0,33,3,3,3,3,3,3,3,3,3,3,3,3,3,3,3,3,3,35,0,0,0,0,0,0,0,0,0,0,0,0,0,0,0,0,0,0,0,0,0,0,0,0,0,0,0,0,0,0,0,0,0,0,0,0],
  [0,0,0,0,0,0,0,0,0,0,0,0,0,0,0,0,0,0,0,0,0,0,0,0,0,0,0,0,0,0,0,0,0,0,0,0,0,0,0,0,0,0,0,0,0,33,3,3,3,3,3,3,3,3,3,3,3,3,3,3,3,3,3,35,0,0,0,0,0,0,0,0,0,0,0,0,0,0,0,0,0,0,0,0,0,0,0,0,0,0,0,0,0,0,0,0,0,0,0,0],
  [4,0,0,0,0,0,0,0,0,0,0,0,0,0,0,0,0,0,0,0,0,0,0,0,0,0,0,0,0,0,0,0,0,0,0,0,0,0,0,0,0,0,0,0,0,33,3,3,3,3,3,3,3,3,3,3,3,3,3,3,3,3,3,35,0,0,0,0,0,0,0,0,0,0,0,0,0,0,0,0,0,0,0,0,0,0,0,0,0,0,0,0,0,0,0,0,0,0,0,0],
  [2,0,0,0,0,0,0,0,0,0,0,0,0,0,0,0,0,0,0,0,0,0,0,0,0,0,0,0,0,0,0,0,0,0,0,0,0,0,0,0,0,0,0,0,0,33,3,3,3,3,3,3,3,3,3,3,3,3,3,3,3,3,3,35,0,0,0,0,0,0,0,0,0,0,0,0,0,0,0,0,0,0,0,0,0,0,0,0,0,0,0,0,0,0,0,0,0,0,0,0],
  [17,0,0,0,0,0,0,0,0,0,0,0,0,0,0,0,0,0,0,0,0,0,0,0,0,0,0,0,0,0,0,0,0,0,0,0,0,0,0,0,0,0,0,0,0,33,3,3,3,3,3,3,3,3,3,3,3,3,3,3,3,3,3,35,0,0,0,0,0,0,0,0,0,0,0,0,0,0,0,0,0,0,0,0,0,0,0,0,0,0,0,0,0,0,0,0,0,0,0,0],
  [17,0,0,0,0,0,0,0,0,8,8,8,8,8,8,8,8,8,8,8,8,8,8,8,8,8,0,0,0,0,24,20,0,0,0,0,0,0,0,0,0,0,0,0,0,33,3,3,3,3,3,3,3,3,3,3,3,3,3,3,3,3,3,35,0,0,0,0,0,0,0,0,0,0,0,0,0,0,0,0,0,0,0,0,0,0,0,0,0,0,0,0,0,0,0,0,0,0,0,0],
  [17,0,0,0,0,0,0,0,0,0,0,0,0,0,0,0,0,0,0,0,0,0,0,0,0,0,0,0,0,0,18,17,0,0,24,16,20,0,0,0,0,0,0,0,0,33,3,3,3,3,3,3,3,3,3,3,3,3,3,3,3,3,3,35,0,0,0,0,0,0,0,0,0,0,0,0,0,0,0,0,0,0,0,0,0,0,0,0,0,0,0,0,0,0,0,0,0,0,0,0],
  [17,0,0,0,0,31,31,0,0,0,0,0,0,0,0,0,0,0,0,0,0,0,0,0,0,0,0,0,0,0,18,26,0,0,18,15,1,0,0,0,0,0,0,0,0,0,3,3,3,3,3,3,3,3,3,3,3,3,3,3,3,3,3,35,0,0,0,0,0,0,0,0,0,0,0,0,0,0,0,0,0,0,0,0,0,0,0,0,0,0,0,0,0,0,0,0,0,0,0,0],
  [17,0,0,0,0,0,0,0,0,0,0,0,0,0,0,0,0,0,0,0,0,0,0,0,0,0,0,0,0,0,18,0,0,0,18,1,26,0,0,0,0,0,0,0,0,0,0,3,3,3,3,3,3,3,3,3,3,3,3,3,3,3,3,35,0,0,0,0,0,0,0,0,0,0,0,0,0,0,0,0,0,0,0,0,0,0,0,0,0,0,0,0,0,0,0,0,0,0,0,0],
  [26,0,0,0,0,0,0,0,31,31,31,31,0,0,0,0,0,0,0,0,0,0,0,0,0,0,0,0,0,0,18,0,0,0,18,17,0,0,0,0,0,0,0,0,0,0,0,0,33,3,3,3,3,3,3,3,3,3,3,3,3,3,3,35,0,0,0,0,0,0,0,0,0,0,0,0,0,0,0,0,0,0,0,0,0,0,0,0,0,0,0,0,0,0,0,0,0,0,0,0],
  [0,0,0,0,0,0,0,0,0,0,0,0,0,0,0,0,0,0,0,0,0,0,0,0,0,0,0,0,0,0,18,4,4,0,18,17,0,0,0,0,0,0,0,0,0,0,0,0,33,3,3,3,3,3,3,3,3,3,3,3,3,3,3,35,0,0,0,0,0,0,0,0,0,0,0,0,0,0,0,0,0,0,0,0,0,0,0,0,0,0,0,0,0,0,0,0,0,0,0,0],
  [0,0,0,0,0,0,31,31,0,0,0,0,0,0,0,0,0,0,0,0,0,0,0,0,0,0,0,0,0,0,18,2,2,16,1,17,0,0,0,0,0,0,0,0,0,0,0,0,33,3,3,3,3,3,3,3,3,3,3,3,3,3,3,3,32,36,0,0,0,0,0,0,0,0,0,0,0,0,0,0,0,0,0,0,0,0,0,0,0,0,0,0,0,0,0,0,0,0,0,0],
  [0,0,0,0,31,31,0,0,0,0,0,0,0,0,0,0,0,0,0,0,0,0,0,0,0,0,0,0,0,24,1,1,1,1,15,17,0,0,0,27,0,0,0,0,0,0,0,0,33,3,3,3,3,3,3,3,3,3,3,3,3,3,3,3,3,3,36,0,0,0,0,0,0,0,0,0,0,0,0,0,0,0,0,0,0,0,0,0,0,0,0,0,0,0,0,0,0,0,0,0],
  [4,0,0,0,0,0,0,0,0,0,0,0,0,0,0,0,0,0,0,0,0,0,0,0,0,0,0,0,24,1,1,1,1,1,1,17,0,0,0,0,0,0,0,0,0,0,0,0,0,3,3,0,0,0,33,3,3,3,3,3,3,3,3,3,3,3,3,0,0,0,0,0,0,0,0,0,0,0,0,0,0,0,0,0,0,0,0,0,0,0,0,0,0,0,0,0,0,0,0,0],
  [23,4,0,0,0,0,0,0,0,0,0,0,0,0,0,0,0,0,0,0,0,0,0,0,0,0,0,24,1,9,1,1,15,1,1,17,0,0,0,0,0,0,0,0,0,0,0,0,0,34,34,0,30,0,33,0,0,0,0,33,3,3,3,3,3,3,3,0,0,0,0,0,0,0,0,0,0,0,0,0,0,0,0,0,0,0,0,0,0,0,0,0,0,0,0,0,0,0,0,0],
  [1,23,0,31,31,31,31,31,0,0,0,0,0,0,0,0,0,0,0,0,0,0,0,0,0,0,0,18,1,1,1,1,15,1,1,17,0,0,0,0,0,0,0,0,0,0,0,0,0,0,0,0,1,0,33,0,24,20,0,33,3,3,3,3,3,3,3,3,3,0,0,0,0,0,0,0,0,0,0,0,0,0,0,0,0,0,0,0,0,0,0,0,0,0,0,0,0,0,0,0],
  [1,17,0,0,0,0,0,0,0,0,0,31,31,31,31,0,0,0,0,0,0,0,0,0,0,0,0,18,1,1,1,1,1,1,1,1,20,0,0,0,24,16,16,16,16,16,16,16,16,16,16,16,17,0,0,0,18,17,0,33,3,3,3,3,3,3,3,3,0,0,0,0,0,0,0,0,0,0,0,0,0,0,0,0,0,0,0,0,0,0,0,0,0,0,0,0,0,0,0,0],
  [19,26,0,0,0,0,0,0,0,0,0,0,0,0,0,0,0,0,0,0,0,0,0,0,0,0,0,18,1,15,1,1,1,15,1,1,1,20,0,0,18,1,1,1,1,1,1,1,1,1,1,1,1,16,16,16,19,26,0,33,3,3,3,3,35,0,0,0,0,0,0,0,0,0,0,0,0,0,0,0,0,0,0,0,0,0,0,0,0,0,0,0,0,0,0,0,0,0,0,0],
  [0,0,0,0,0,0,0,0,0,0,0,0,0,0,0,0,0,24,16,16,20,0,0,0,0,0,0,18,1,1,1,1,1,1,1,1,19,26,0,0,18,1,1,1,1,1,1,1,15,1,1,1,1,17,0,0,0,0,0,0,0,0,33,3,35,0,0,0,0,0,0,0,0,0,0,0,0,0,0,0,0,0,0,0,0,0,0,0,0,0,0,0,0,0,0,0,0,0,0,0],
  [0,0,0,0,0,0,0,0,0,0,0,0,0,0,0,0,0,25,19,19,26,0,0,0,0,0,0,18,1,1,1,1,19,19,19,26,0,0,0,24,1,1,15,1,1,1,1,1,1,1,1,15,1,26,0,0,0,0,0,0,0,0,0,0,0,0,0,0,0,0,0,0,0,0,0,0,0,0,0,0,0,0,0,0,0,0,0,0,0,0,0,0,0,0,0,0,0,0,0,0],
  [0,0,0,0,0,0,0,0,0,0,0,0,0,0,0,0,0,0,0,0,0,31,0,0,0,0,0,18,1,15,1,17,0,0,0,0,0,24,16,1,1,1,1,1,1,1,1,1,1,1,1,1,26,0,0,0,0,0,0,0,0,0,0,0,0,0,0,0,0,0,0,0,0,0,0,0,0,0,0,0,0,0,0,0,0,0,0,0,0,0,0,0,0,0,0,0,0,0,0,0],
  [0,0,0,0,0,0,0,0,0,0,0,0,0,0,0,0,0,0,0,0,0,0,0,0,4,4,4,18,1,15,1,17,0,0,0,0,0,18,1,1,1,1,1,1,1,1,1,15,1,1,19,26,0,0,0,0,0,0,0,0,0,0,0,0,0,0,0,0,0,0,0,0,0,0,0,0,0,0,0,0,0,0,0,0,0,0,0,0,0,0,0,0,0,0,0,0,0,0,0,0],
  [0,0,0,0,0,0,0,0,0,0,0,4,4,0,0,0,0,0,0,0,0,0,0,4,22,2,2,1,1,1,1,17,0,27,19,19,19,1,1,1,1,1,1,1,15,1,1,1,1,26,0,0,0,0,0,0,0,0,0,0,0,0,0,0,0,0,0,0,0,0,0,0,0,0,0,0,0,0,0,0,0,0,0,0,0,0,0,0,0,0,0,0,0,0,0,0,0,0,0,0],
  [0,0,0,0,0,0,0,0,0,0,4,22,23,4,4,0,0,0,0,0,0,0,0,22,1,1,1,1,1,1,1,17,0,0,0,0,0,18,15,1,1,1,1,1,1,1,1,1,17,0,0,0,0,0,0,0,0,0,0,0,0,0,0,0,0,0,0,0,0,0,0,0,0,0,0,0,0,0,0,0,0,0,0,0,0,0,0,0,0,0,0,0,0,0,0,0,0,0,0,0],
  [0,0,0,0,0,0,0,0,0,0,22,1,1,2,23,4,4,0,0,4,4,4,4,1,1,15,1,1,19,19,19,1,16,20,0,0,0,18,1,1,1,1,1,1,1,1,1,1,17,0,0,0,0,0,0,0,0,0,0,0,0,0,0,0,0,0,0,0,0,0,0,0,0,0,0,0,0,0,0,0,0,0,0,0,0,0,0,0,0,0,0,0,0,0,0,0,0,0,0,0],
  [0,0,0,0,0,0,0,0,0,4,1,1,1,1,1,2,23,0,0,22,2,2,2,1,1,1,1,26,0,0,0,18,15,1,16,29,0,18,1,1,1,9,9,1,1,1,1,1,17,0,0,0,0,0,0,0,0,0,0,0,0,0,0,0,0,0,0,0,0,0,0,0,0,0,0,0,0,0,0,0,0,0,0,0,0,0,0,0,0,0,0,0,0,0,0,0,0,0,0,0],
  [0,0,0,0,0,0,0,4,4,22,1,1,1,1,1,1,17,0,0,18,19,19,19,19,19,19,26,0,0,0,0,18,19,26,0,0,0,18,1,1,1,1,1,1,1,1,15,1,17,0,0,0,0,0,0,0,0,0,0,0,0,0,0,0,0,0,0,24,16,16,16,16,16,16,16,16,16,16,16,20,0,0,0,0,0,0,0,0,0,0,0,0,0,0,0,0,0,0,0,0],
  [4,4,4,4,4,4,4,22,2,1,1,1,15,1,1,1,1,16,16,17,0,0,0,0,0,0,0,0,24,20,0,18,0,0,0,24,16,1,1,1,1,1,1,1,1,1,1,1,1,16,20,0,0,0,0,0,0,0,0,0,0,0,0,0,0,24,16,1,1,1,1,15,1,1,1,1,1,1,1,1,16,16,20,0,0,0,0,0,0,0,0,0,4,4,4,4,4,4,4,4],
  [2,2,2,2,2,2,2,1,1,1,1,1,15,1,1,15,1,1,19,26,0,24,16,16,16,16,16,16,1,17,0,18,0,24,16,1,1,1,1,1,1,15,1,1,1,1,1,1,1,1,1,16,16,0,0,0,0,0,0,0,0,0,24,16,16,1,1,1,1,1,1,1,1,1,1,15,1,1,1,1,1,1,1,16,20,4,4,4,4,4,4,4,22,2,2,2,2,2,2,2],
  [1,1,1,17,0,0,25,19,19,19,19,19,19,19,19,19,19,26,0,0,0,18,1,1,1,1,1,15,1,17,0,28,0,18,1,1,1,1,1,1,1,1,1,1,1,1,1,1,15,1,1,1,1,16,16,16,16,16,16,16,16,16,1,1,1,1,1,1,15,15,1,1,1,1,1,1,1,1,1,1,15,1,1,1,1,2,2,2,2,2,2,2,1,1,1,1,9,1,1,1],
  [1,1,1,17,4,4,0,0,0,0,0,0,0,0,0,0,0,0,0,24,16,1,1,9,9,1,1,1,1,17,0,0,0,18,1,1,15,1,1,1,1,1,1,1,1,1,1,1,1,1,1,1,1,1,1,1,1,15,1,1,1,1,1,1,1,1,1,1,1,1,1,1,1,1,1,15,15,1,1,1,1,1,15,1,1,1,1,1,1,1,1,1,1,9,1,1,1,1,1,1],
  [1,1,1,1,2,2,16,16,16,16,16,16,16,16,16,16,16,16,16,1,1,1,1,1,1,1,1,1,1,1,16,16,16,1,1,1,1,1,1,1,1,1,1,1,1,1,1,1,1,1,1,1,1,1,1,1,1,1,1,1,1,1,1,1,1,1,1,1,1,1,1,1,1,1,1,1,1,1,1,1,1,1,1,1,1,1,1,1,1,1,1,1,1,1,1,1,1,1,1,1]
]